1111111111111111111111111111111111111111111111111111111111111
1P00000000100000100000100000001000100000000010000010000000001
1011111010111110101010111110101010101011101010101010111011101
100010001000001000101010000010001000100000101010100N000000101
1110101111111010111010101010111110101111101010101011111110101
100N00001000101010001000101000001010001000101C101000000010101
1010111010111010101111111010101010111010111011101111111010101
101N0010100N0010100000000010101010000010001010001C00001N00101
1010101010101010111011101010101011101110101010111110101011101
1010101010100010100010000010001000100000101000100N000N00001E1
1010101010101011101110101011101110101111101111101011111010101
10001000101000100010001C1000101000100000000010001000000010001
1111111110111110111010111110101011101110111010111110111011111
1000000000100000001010000000100N10001000000010101000000000101
1011101110101110101010111111111010111011101010101010111110101
10001000000010001010000010000000100010000N1C100N0010001000101
1110111011111011101011101010101111101111101110101110101011101
1C100010000000100000000010100N000C100000100010000010100000001
1010101111101110111111101110111011111110111010101010101111101
10000N000000100N0000000000001C000000000N0C10000N0000100000001
1111111111111111111111111111111111111111111111111111111111111