11111
1CCP1
1ECC1
1NNN1
1NNN1
1NNN1
1NNN1
1NNN1
1NNN1
1NNN1
1NNN1
1NNN1
1NNN1
1NNN1
1NNN1
1NNN1
1NNN1
1NNN1
1NNN1
1NNN1
1NNN1
1NNN1
1NNN1
1NNN1
1NNN1
1NNN1
1NNN1
1NNN1
11111
