1111111111111111111111111111111111111111111
1P01001010001001000100010001001000000100101
1010101010100101010101000101010010010101001
1010000100010000100001000100010001000010001
1011111010101010101010101010101010101010101
10000C0000000000000000000000000000000000001
1101010101010101010101010101010101010101011
1000000000000000000000100000000000000000001
1010101010101010101010101010101010101010101
100000N00000N000000000100000000000000000001
1010101010101010101010101010101010101010101
1000000000C0C000000000000000000000000000001
1010101010101010101010101010101010101010101
1000C00N0C000000000000000000000000000000001
1010101010101010101010101010101010101010101
1000000N00000000000000000000000000000000001
1010101010101010101010101010101010101010101
10000000000000000000000000000000000000000E1
1111111111111111111111111111111111111111111
